in	iin
of	fo
and	adn
can	cxan
for	fo
his	hes
its	its's
the	hte hten
you	u
away	awya
back	bakc
been	beeen
does	doens
fell	falled
from	ffrom
have	ahev
here	htere
into	inot
it's	its's
just	jstu
knew	knowed
know	knwo
like	liek
lose	loose
made	maked 
next	enxt
nice	neice 
quit	quited
said	sayed 
shot	shooted 
some	smoe 
soon	soons 
than	tahn 
then	hten
they	htey tyhe 
time	timne  tiem 
told	telled 
upon	apon
very	veyr 
well	wel 
went	whent 
were	weere 
what	waht 
when	wehn 
will	iwll
with	iwth
work	owrk 
your	ur
a lot	alot
about	baout boaut
after	affter
again	agian
along	allong
April	april
broke	broked breaked
built	builded
chief	cheif
chose	chosed choosed
could	coudl
enemy	enemey
every	eveyr eery
field	feild
fiery	firey
first	firt
forty	fourty
found	foudn
gauge	guage
going	gogin
guard	gurad gaurd
heard	heared
house	housr
loose	loose
maybe	mabye 
money	moeny 
niece	neice 
ninth	nineth 
piece	peice 
place	palce 
quiet	qtuie
quite	qtuie quited
right	rigth 
seize	sieze 
their	theit  ther 
there	htere ther 
think	htikn
tried	tryed 
truly	truely 
until	untill  unti 
usage	useage 
wants	want's 
weird	wierd 
whose	whos 
women	womens 
would	owudl 
write	wriet 
years	eyars
across	accros
afraid	affraid
always	allways
anyway	anyways
around	arround
babies	babys
before	befoer
belief	beleif
bought	buyed
cannot	cant
caught	catched
column	collum
coming	comming
coolly	cooly
didn't	didnt did'nt
easily	easiliy easly
exceed	excede
family	famaly
friend	firend
harass	haras
having	haveing
height	heighth
heroes	heros
hoping	hopeing
likely	likley
little	littel litle
luxury	luxary
ninety	nintey 
origin	orgin 
others	otheres 
people	peopel 
pursue	persue  puruse 
really	realy  erally
recipe	recepie 
rhythm	rhythem 
safety	saftey  safetly 
salary	salery 
secede	seceed 
simply	simpley 
tariff	tarif 
tenant	tennant 
that's	thast 
things	thigsn 
vacuum	vaccum 
wanted	wnated 
wholly	wholely  wholy 
absence	abscence
achieve	acheive
address	addres
already	allready
asphalt	ashphalt
atheist	athiest
because	beacause
believe	beleave
Britain	Britan
brother	borther
brought	brang
buoyant	bouyant
capital	captial
ceiling	cieling
condemn	condem
counsel	consel
deceive	decieve
despair	dispair
develop	develope
disease	desease
dropped	droped
exhaust	exaust
expense	expence
finally	fianlly
foreign	foriegn
foresee	forsee
forfeit	forefeit
friends	friens
fulfill	fufill
grabbed	grabed
grammar	grammer
heinous	henious
ideally	idealy
jewelry	jewlrey
leisure	leasure
library	libarary
license	liscense lisence
minimum	miminum 
minutes	mintues 
missile	misile 
neither	niether 
omitted	omited 
opinion	opionion 
outside	oustide 
pastime	passtime 
precede	preceed  procede 
proceed	procede 
process	proccess 
pursuit	persuit 
quizzes	quizes
realize	relize 
receive	recieve 
running	runing 
scenery	scenary 
several	severall 
shining	shineing 
special	speacial  spacial 
sponsor	sponser 
spotted	spoted 
stepped	steped 
stopped	stoped 
succeed	seceed 
success	succes 
summary	sumary 
suppose	supose 
thought	throught  tought 
through	thru  throught 
tonight	tongiht 
tragedy	tradgedy 
twelfth	twelth 
tyranny	tyrany 
usually	usally  usuall 
village	vilage 
villain	villian 
visible	visable 
weather	wether 
without	wihtout 
writing	wirting 
written	writen  writed 
allotted	alotted
ambience	ambiance
anything	anytying
apparent	aparent
argument	arguement
asterisk	asterick
boundary	bondary
bulletin	bulliten
business	buisness
calendar	calander
campaign	campain
category	catagory
cemetery	cementary
changing	changeing
children	childern
colossal	collosal
conceive	concieve
definite	deffinite
describe	decribe
dominant	dominent
eligible	eligable
equipped	equiped
existent	existant
familiar	familar
February	Febrary
finished	finnished
flexible	flexable
formerly	fomerly
governor	gouvener
grateful	gratefull
grievous	grevious
guerilla	guerrila
guidance	guidence
happened	hapened
humorous	humerous
judgment	judgement
judicial	judical
maneuver	maneover 
medicine	medacine 
medieval	medievel  medeival 
mediocre	medicore 
mortgage	morgage 
neighbor	nieghbor  neigbor 
nowadays	now adays 
obstacle	obstacal 
occasion	ocasion 
occurred	occured 
official	offcial 
omission	omision 
opponent	oponent 
optimism	optomism 
parallel	paralel 
peculiar	pecular 
perceive	percieve 
persuade	persaude 
physical	fysical
pleasant	pleasnat 
possible	posible 
potatoes	potatos 
probably	probablly 
received	recepted 
referred	refered 
relevant	relavent 
remember	rember 
roommate	roomate 
sandwich	sandwhich 
schedule	schedual 
separate	seperate 
sergeant	sargant 
souvenir	souvenier 
specimen	speciemen 
strategy	startegy 
strength	strenght 
studying	studing 
suppress	supress 
surprise	supprise 
surround	suround 
swimming	swiming 
tendency	tendancy 
together	togather 
tomorrow	tommorow 
vigilant	vigilent 
violence	violance 
wherever	whereever 
abundance	abudance
accordion	accordeon
aggravate	agravate
alignment	allignment
all right	allright
apartment	appartmant
assistant	assitant
auxiliary	auxillary
basically	basicaly
beautiful	beatiful
beginning	beggining
brilliant	briliant
candidate	candadate
challenge	challange
committee	comittee
competent	competant
consensus	concensus
corollary	correlary
criticism	critiscism
criticize	critiscize critise
desirable	desireable
desperate	desparate
developed	developped
different	diferent
disappear	disapear
embarrass	embarass
equipment	equippment
existence	existance
extremely	extremley
genealogy	geneology
generally	generaly
guarantee	garantee
Halloween	Hallowean
hindrance	hinderence
hypocrisy	hypocracy
hypocrite	hypocrit
imaginary	imagenary
immediate	imediate
immigrant	inmigrant imigrant
implement	impliment
insistent	insistant
interpret	interpet
interrupt	interupt
introduce	inctroduce introduct
knowledge	knowldge
literally	literaly
magically	magicaly 
miniature	minature 
naturally	natuarlly 
necessary	neccesary 
obedience	obediance 
permanent	permanant 
personnel	personell  personel 
pollution	polution 
possesses	posesses 
preceding	preceeding  proceding 
preferred	prefered 
prejudice	predjudice 
prevalent	prevelant 
primitive	primative 
principal	pricipal 
principle	priciple 
privilege	priveledge 
procedure	procedger 
professor	profesor 
prominent	prominant 
recommend	reccomend 
reference	referance 
religious	religeous 
reservoir	reservor 
sacrifice	sacrafice 
satellite	satalite 
secretary	secratary 
sincerely	sincerley 
soliloquy	soliliquy 
sophomore	sophmore 
strenuous	strenous 
supersede	supercede 
technical	techical 
therefore	therfore 
unanimous	unaminous 
vengeance	vengance 
absorption	absorbsion
accessible	accessable
accomplish	acomplish
aggressive	aggresive
appearance	apearance
attendance	attendence
bankruptcy	backruptcy
believable	believeable
camouflage	camoflage
changeable	changable
collateral	colateral
commitment	committment
competitor	competor
completely	completly
conscience	concience
consistent	consistant
continuous	continious
controlled	contolled
convenient	conveinent
definitely	definately
difference	diference
disappoint	disapoint
disastrous	disasterous
equivalent	equilavent
especially	expecially
exaggerate	exagerate
excellence	excellance
exhilarate	exhilirate
experience	experiance
experiment	experement
exuberance	exhuberance
government	goverment
harassment	harasment
hemorrhage	hemmorhage
incredible	increadible
irrelevant	irelevent
legitimate	legimate
lieutenant	leutenant
likelihood	likelyhood
loneliness	lonelyness
manageable	managable 
mysterious	misterious 
noticeable	noticable 
occurrence	occurance 
parliament	paliament 
particular	parituclar 
persistent	persistant 
propaganda	propoganda 
psychology	psycology 
repetition	repetion 
resistance	resistence 
restaurant	restarant  restraunt 
ridiculous	rediculous 
statistics	stastics 
succession	succesion 
sufficient	suffcient 
supposedly	suposedly 
synonymous	synonomous 
tournament	tornament 
accommodate	accomadate
achievement	acheivement
appropriate	appropiate
bureaucracy	beaurocracy
comparative	comparitive
convertible	convertable
description	discription
development	developement
discrepancy	discrepency
environment	enivoriment
explanation	explaination
financially	financialy
immediately	emmediately
independent	indepedent
interesting	intersting
maintenance	maintainance 
mathematics	mathamatics 
mischievous	mischeivous 
opportunity	opertunity 
performance	peformance 
preparation	prepartion 
remembrance	rememberance 
resemblance	resemblence 
spontaneous	spontanious  sponteous 
susceptible	subceptible 
symmetrical	symetrical 
temperature	temperture 
transferred	transfered 
unnecessary	unecessary 
accidentally	accidentaly
acquaintance	acquaintence
advantageous	advantagous
dissatisfied	disatisfied
embarrassing	embarassing
handkerchief	hankerchief
incidentally	incidently
intelligence	inteligence
intermediary	intermidiary
irresistible	iresistable
occasionally	ocasionally 
particularly	particularily 
perseverance	perserverance 
specifically	specificaly 
stubbornness	stubborness 
consciousness	conciousness
disappearance	disappearence
extraordinary	extrordinary
fundamentally	fundamentaly
indispensable	indispensible
pronunciation	pronounciation 
questionnaire	questionaire
characteristic	characterstic
correspondence	correspondance
representative	represenative 
superintendent	superintendant 
congratulations	congradulations